R      480     640
NO ./path_to_the_north_texture
SO       ./path_to_the_south_texture
WE ./path_to_the_west_texture
EA    ./path_to_the_east_texture
S ./path_to_the_sprite_texture
F                220    ,100,      0
C 225 ,30,      0

111111111111111111111111111111
110000W001100000000000011
10110000011100000020000011
10010000000000000000000011111111
111111111011000001111000000000001
100000000011000001110111111111111
11110111111111011100000010001
11110111111111011101010000001
11000000110101011100000010001111111
 11111100020000000000011000000100011111
 111111000000000000000000110101001000111
110000011101010111110111100111111111111
11110111 1110101 101111010001
11111111 1111111 1111111111111


111111111